16
50
********************* ****************************
********                             **          *
********** ********** ************** ** **********
********** ********** **************    **********
******                ******     *****************
****** *** ***************** *** *****************
**     *** ***************** *** *****************
** *******        **         *** *****************
**    **** ****** ** *********** ***    **********
***** **** ******    *******     **  ** **********
***** ****    ************** ******* ** **********
***** ******* **************         ** **********
***** ******* ************************* **********
*****         *****************         **********
******************************* ******* **********
*************************************** **********
