39
65
****************** **********************************************
****************** **********************************************
****************** **********************************************
**                                                        *******
** *********** ****************************************** *******
** *********** ****************************************** *******
** ***********                              ************* *******
** *********** **************************** ************* *******
** *********** *******                 **** ************* *******
** *********** ******* *************** **** *************     ***
** *********** ******* ***************      ***************** ***
** *********** ******* *************** ********************** ***
** *********** *******           ***** ********************** ***
** *********** *********************** ********************** ***
** *********** *********************** ********************** ***
** **                                                         ***
** ** ************************* *********************************
** ** *******************                               *********
** ** ******************* ***************************** *********
** ** ******************* ***************************** *********
** ** **************                            ******* *********
** ** ***************************************** ******* *********
** ** ***************************************** ******* *********
** ** ***************************************** ******* *********
** **                                           ******* *********
** *********** ****************** ********************* *********
** *********** ****************** ********************* *********
** ***********               **** ********************* *********
** ************************* **** *******************************
** ************************* **** *******************************
** *                         ****                   *************
** * ************************************************************
** * *************      **    **    **    ***********************
** * ************* **** ** ** ** ** ** ** ***********************
** *               ****    **    **    **               *********
** **************************************************** *********
**                                                    * *********
******************************************************* *********
******************************************************* *********